111111111111111111
100P00000E0C000001
111111111111111111
