11111111111111
1P000000000001
111000000C0001
1E000000000001
11100000000001
10000000000001
11111111111111